############
#FFFFFFFFFF#
#FF####FFFF#
#FF######FF#
#FFFF#FF#FF#
#FTF#FFFFFF#
#FTF#FF###F#
#FFF#FFF#FF#
#FFF#FFFFFF#
#FFF#FFFFFF#
#FFFFFFFFFF#
############
