############
#TFFFFFFFFF#
#FF####TFFF#
#FF######FF#
#FFFF#FT#FF#
###F#FFFFFF#
#F#F#FF###F#
#F#F#FFT#FF#
#F#F#FFFFFF#
#FFF#TFFFFF#
#FFFFFFFFFF#
############
